WWWWWWWWWWWW
WXXBXXXXXXXW
WXXXXBXSXXXW
WXXBXXXXXXSW
WXXXXBSXXXXW
WWSWBXXSXXXW
WWSWWBXWWWWW
WXXBXWWXXXXW
WXSXXBXXXXXW
WXXBXXSXXPXW
WXSXXBXXXXXW
WWWWWWWWWWWW