WWWWWWWWWWWW
WXXBXXXXXXXW
WXXXXBXSXXXW
WXKBXXXXXXSW
WXMXXBSXXXXW
WWMWBXXSXXXW
WWSWWBXWWWWW
WXXBXWWXXXXW
WXSXXBXXXXXW
WXXBXXSXXPXW
WXSXXBXXXXXW
WWWWWWWWWWWW

____________
____________
____________
____________
____________
____________
____________
_________Xl_
_________u__
__________d_
_________rX_
____________