WWWWWWWWWWWWW
WSXXXXSXXXXSW
WXXXXXPXXXXXW
WXXXXXBXXXXXW
WXXXBXXXBXXXW
WXXXXXXXXXXXW
WSXBXXIXXBXSW
WXXXXXXXXXXXW
WXXXBXXXBXXXW
WXXXXXBXXXXXW
WXXXXXXXXXXXW
WSXXXXSXXXXSW
WWWWWWWWWWWWW
