WWWWWWWWWWWW
WXXSXXXXSXXW
WXXXXXXXXXXW
WXXXXXXXXXXW
WXTXXXXXXTXW
WXXXXXXSXXXW
WWWWWXWWWWWW
WXXXXXXXXXXW
WXXXXBXXXXXW
WXSXXPXXXSXW
WSXXXXXBXXSW
WWWWWWWWWWWW

____________
____XAXX____
___X____X___
___X____X___
___X_d__X___
__rX_X__Xl__
_____X______
____________
__rB___Bl___
____________
____________
____________

____________
____________
____________
____________
____________
_____d______
_____X______
____________
____________
____________
____________
____________